15 15 15 15 15 15 15 15 17 17 15 15 15 15 15 15 15 15 15 15 15 15 15 15 15 15 17 15 15 15 15 15 15 15 15 15 15 15 15 15 15 15 15 15 15 15 15 15 15 15 
15 15 17 15 15 15 15 15 15 15 15 15 15 15 17 15 15 15 15 15 15 15 15 15 15 15 15 15 15 15 15 15 15 15 15 15 15 15 15 15 15 15 16 15 17 15 15 15 15 15 
15 15 16 15 15 15 21 18 18 18 18 18 19 15 15 15 15 15 17 15 15 17 15 15 17 15 15 15 15 17 15 15 15 15 15 15 15 17 15 15 15 15 15 15 15 15 17 15 17 15 
15 17 15 15 15 21 22 1 33 1 1 1 20 18 19 15 15 15 15 15 15 15 16 15 15 15 15 15 15 15 15 15 16 15 15 21 18 18 18 19 15 15 17 15 15 15 15 15 15 15 
15 15 21 18 18 22 1 1 1 1 1 33 1 1 20 18 18 18 19 15 15 17 15 15 15 15 21 18 18 18 18 18 18 18 18 22 1 1 1 20 19 15 15 15 15 15 15 15 15 15 
15 21 22 1 1 1 1 1 1 1 1 1 1 1 1 1 1 2 20 18 18 18 18 18 18 18 22 1 1 1 1 33 1 33 1 1 1 33 1 1 20 19 15 15 15 17 17 15 15 15 
15 24 1 33 2 1 33 1 31 31 31 31 31 1 1 1 1 33 1 1 1 1 5 7 3 1 1 33 1 1 33 33 33 1 1 1 5 7 1 1 1 20 18 19 15 15 15 15 15 15 
15 24 1 2 1 1 1 1 31 30 30 30 31 1 33 1 33 33 33 33 33 1 9 30 8 1 2 1 33 33 33 33 33 33 1 33 9 30 8 1 1 1 1 20 18 19 15 15 15 15 
15 24 1 1 1 33 1 2 31 30 30 30 31 1 1 1 33 33 33 33 1 1 12 14 10 1 1 1 33 33 33 2 33 33 1 1 12 14 10 2 1 33 33 1 1 20 18 18 19 15 
15 24 1 2 1 1 1 1 31 30 30 30 31 1 33 1 33 33 33 33 2 2 5 7 3 1 1 1 33 33 33 33 33 33 33 1 5 7 7 7 7 7 3 1 1 33 1 1 23 15 
15 24 1 1 1 2 2 1 31 30 30 30 31 1 1 1 33 33 33 33 33 1 9 30 8 1 1 33 33 33 33 33 33 33 33 33 9 30 30 30 30 30 8 1 33 33 2 1 23 15 
15 24 1 1 33 1 1 1 31 31 30 31 31 1 1 1 33 2 33 33 33 1 9 30 8 1 33 33 33 33 2 1 33 2 2 33 12 14 14 14 13 30 8 1 1 1 1 27 26 15 
15 28 29 1 1 1 1 1 1 9 30 8 1 2 1 33 33 33 33 33 33 1 9 30 8 1 33 33 33 1 2 1 33 33 33 33 33 33 1 2 9 30 8 33 33 1 27 26 15 15 
15 15 24 1 1 2 1 2 1 9 30 8 1 1 33 33 33 33 33 2 33 1 9 30 8 2 33 33 2 5 7 3 1 33 33 33 33 33 1 1 9 30 8 1 1 1 23 15 17 15 
15 17 24 1 1 5 7 7 7 6 30 8 33 33 33 33 33 33 33 33 33 1 9 30 8 1 33 33 1 9 30 8 2 33 33 33 33 33 33 1 9 30 8 1 33 1 23 15 15 15 
15 15 24 1 2 9 30 30 30 30 30 8 33 33 33 33 33 2 2 33 33 1 9 30 8 1 33 33 33 9 30 8 1 33 33 2 33 33 33 1 9 30 8 33 1 1 23 15 16 15 
15 15 24 1 1 9 30 11 14 14 14 10 1 33 33 33 33 33 33 33 33 1 9 30 8 1 33 2 33 9 30 8 1 33 33 33 33 33 33 1 9 30 8 1 1 1 20 19 15 15 
15 15 24 1 1 9 30 8 33 33 1 33 33 33 33 33 33 33 33 33 33 33 9 30 8 1 1 33 33 9 30 8 33 33 33 33 33 33 33 33 9 30 8 1 33 1 1 23 15 15 
15 15 28 29 1 9 30 8 33 33 33 33 33 33 33 33 33 33 1 1 1 33 9 30 8 1 2 1 33 9 30 8 33 33 33 33 33 33 33 33 9 30 8 33 33 33 1 23 15 15 
15 17 15 24 1 9 30 8 33 33 33 33 33 33 33 33 33 1 1 2 1 2 9 30 8 2 1 1 1 9 30 8 33 1 1 33 33 33 33 33 9 30 8 33 33 33 1 23 17 15 
15 15 15 28 29 9 30 8 1 33 33 5 7 7 7 7 7 7 7 7 7 7 6 30 4 7 7 7 7 6 30 4 7 7 7 7 7 7 7 7 6 30 8 1 33 33 1 23 17 15 
15 15 17 15 24 9 30 8 1 33 33 9 30 30 30 30 30 30 30 30 30 30 30 30 30 30 30 30 30 30 30 30 30 30 30 30 30 30 30 30 30 30 8 1 33 1 27 26 15 15 
15 15 17 15 24 9 30 8 33 33 33 31 30 31 14 14 14 14 14 14 14 14 13 30 11 14 14 14 14 14 14 14 14 14 14 14 14 14 14 14 13 30 8 1 1 1 23 15 17 15 
15 17 15 21 22 9 30 8 33 33 33 9 30 8 33 33 1 1 1 2 33 1 9 30 8 1 33 2 1 1 1 27 29 1 1 1 33 1 1 33 9 30 8 1 33 1 20 19 15 15 
15 15 15 24 1 9 30 8 33 33 33 9 30 8 2 33 33 1 33 1 1 1 9 30 8 33 1 1 1 27 25 26 28 25 25 29 1 1 1 1 9 30 8 33 33 1 1 23 15 15 
15 17 15 24 1 9 30 8 33 33 2 9 30 8 1 33 33 33 33 1 1 1 9 30 8 1 1 33 27 26 15 17 15 15 15 28 29 1 1 33 9 30 8 1 1 1 27 26 15 15 
15 15 15 24 1 9 30 8 33 33 1 9 30 8 1 33 33 33 1 1 1 2 9 30 8 33 1 1 23 16 15 15 15 17 17 15 24 1 1 1 9 30 8 1 1 27 26 15 15 15 
15 15 21 22 1 9 30 4 31 7 7 6 30 8 33 33 33 1 1 1 1 1 9 30 8 1 1 27 26 15 15 17 15 15 17 16 28 29 1 1 9 30 8 33 1 23 15 15 15 15 
15 15 24 1 1 9 30 30 30 30 30 30 30 8 33 33 1 2 1 1 33 1 9 30 8 1 27 26 15 17 15 15 15 15 15 15 15 24 1 1 9 30 8 1 2 23 15 15 17 15 
15 15 24 1 33 12 14 14 31 14 14 14 14 10 33 33 1 1 1 1 1 1 9 30 8 1 23 15 15 15 15 17 15 15 15 15 15 24 1 33 9 30 8 1 1 20 19 15 15 15 
15 15 24 1 1 1 1 1 33 33 33 33 1 33 33 1 27 25 29 2 1 1 9 30 8 2 20 19 16 15 15 15 17 15 15 17 15 24 1 1 9 30 8 33 1 1 23 15 15 15 
15 15 24 1 1 1 1 33 33 33 2 33 33 33 33 1 23 16 28 29 1 1 9 30 8 1 1 23 15 15 16 15 15 17 15 15 15 24 1 33 9 30 8 1 1 1 23 15 15 15 
15 15 24 1 33 1 33 33 33 33 33 1 33 33 33 1 20 18 18 22 1 1 9 30 8 33 1 20 19 16 21 18 18 19 15 16 15 24 1 1 9 30 8 1 33 1 20 19 15 15 
15 17 24 1 1 1 33 33 33 33 33 33 33 33 1 1 1 1 2 1 1 2 9 30 8 1 2 1 20 18 22 1 33 20 18 18 18 22 1 33 9 30 8 33 33 33 1 23 15 15 
15 15 24 1 1 1 1 33 2 33 33 33 33 33 33 33 1 1 33 1 1 1 9 30 8 1 1 33 1 1 1 33 1 1 2 1 1 2 1 1 9 30 8 33 33 33 1 23 15 15 
15 15 28 29 1 33 1 33 33 33 33 33 33 33 33 33 33 1 1 1 1 1 9 30 4 3 5 7 7 3 5 7 7 7 7 7 7 7 7 7 6 30 8 1 33 33 27 26 15 15 
15 15 15 24 1 1 1 33 33 33 33 1 33 1 33 33 33 1 1 33 2 1 9 30 30 4 12 13 30 8 9 30 30 30 30 30 30 30 30 30 30 30 8 1 1 1 23 15 15 15 
15 15 15 28 29 1 1 1 33 1 33 33 33 33 1 33 33 33 1 1 2 1 9 30 11 14 10 12 14 10 12 14 14 14 14 14 13 30 11 14 14 14 10 33 1 1 23 15 15 15 
15 15 17 15 28 29 1 1 1 1 33 33 33 33 33 33 33 33 33 1 1 1 12 14 1 2 1 1 1 1 1 1 1 1 1 2 9 30 8 33 1 1 33 33 33 1 23 15 15 15 
15 15 15 15 15 28 25 25 29 1 1 1 1 1 1 1 1 33 33 1 33 1 5 7 3 1 1 1 33 33 33 33 33 33 1 1 9 30 8 1 1 2 33 33 33 1 23 15 17 15 
15 15 15 15 15 15 15 15 28 25 25 25 25 25 29 1 1 1 33 1 1 1 9 30 8 1 33 33 33 33 33 33 2 33 33 1 12 14 10 2 1 1 1 33 1 1 23 15 15 15 
15 15 15 15 15 15 15 15 15 15 17 15 15 15 28 29 1 1 33 1 1 1 12 14 10 1 33 33 2 33 33 33 33 33 33 1 5 7 3 1 1 33 33 1 1 1 23 15 15 15 
15 15 15 17 15 15 15 15 15 15 15 15 15 15 15 24 1 33 1 1 1 1 1 1 1 1 1 33 33 33 33 33 33 33 1 1 9 30 8 1 33 33 33 33 1 27 26 15 15 15 
15 15 15 15 15 15 15 15 15 15 15 15 15 15 15 28 29 1 1 1 27 25 25 25 29 1 1 1 1 33 2 33 1 1 1 2 12 14 10 1 33 33 33 33 1 23 15 15 15 15 
15 15 15 15 15 15 15 15 17 15 15 15 15 15 15 17 28 25 25 25 26 15 15 15 28 29 1 1 1 1 1 1 1 33 1 1 1 1 2 1 33 33 33 33 1 23 16 15 15 15 
15 15 17 15 15 17 15 15 15 15 15 15 17 17 15 15 15 15 15 15 15 15 15 15 15 28 29 1 27 25 29 1 1 1 1 2 1 1 1 1 1 33 33 1 1 23 15 15 15 15 
15 15 15 15 15 15 15 15 15 15 15 15 17 15 15 15 15 15 17 15 15 15 17 16 15 15 28 25 26 15 28 25 29 1 1 1 27 25 25 29 1 1 1 1 27 26 15 15 17 15 
15 15 15 15 15 15 15 15 17 15 15 15 15 15 15 15 15 15 15 15 15 15 15 15 15 17 15 15 15 15 15 15 28 29 1 27 26 15 15 28 25 25 25 25 26 15 15 15 15 15 
15 15 15 15 15 15 15 15 15 15 15 15 15 15 15 15 15 15 15 15 15 17 15 15 15 15 15 17 15 15 15 15 15 28 25 26 15 17 15 15 15 15 15 15 15 15 17 15 15 15 
15 15 15 15 15 15 15 15 15 15 15 15 15 15 15 15 15 15 15 15 15 15 15 15 15 15 15 15 15 17 15 15 15 15 15 15 15 15 15 15 15 15 15 15 15 17 17 15 15 15 
