15 15 15 15 15 15 15 15 17 17 15 15 15 15 15 15 15 15 15 15 15 15 15 15 15 15 17 15 15 15 15 15 15 15 15 15 15 15 15 15 15 15 15 15 15 15 15 15 15 15 
15 15 17 15 15 15 15 15 15 15 15 15 15 15 17 15 15 15 15 15 15 15 15 15 15 15 15 15 15 15 15 15 15 15 15 15 15 15 15 15 15 15 16 15 17 15 15 15 15 15 
15 15 16 15 15 15 21 18 18 18 18 18 19 15 15 15 15 15 17 15 15 17 15 15 17 15 15 15 15 17 15 15 15 15 15 15 15 17 15 15 15 15 15 15 15 15 17 15 17 15 
15 17 15 15 15 21 22 1 33 1 1 1 20 18 19 15 15 15 15 15 15 15 16 15 15 15 15 15 15 15 15 15 16 15 15 21 18 18 18 19 15 15 17 15 15 15 15 15 15 15 
15 15 21 18 18 22 1 1 1 1 1 33 1 1 20 18 18 18 19 15 15 17 15 15 15 15 21 18 18 18 18 18 18 18 18 22 1 1 1 20 19 15 15 15 15 15 15 15 15 15 
15 21 22 1 1 1 1 2 1 1 1 1 1 1 1 1 1 2 20 18 18 18 18 18 18 18 22 1 1 1 1 33 1 33 1 1 1 33 1 1 20 19 15 15 15 17 17 15 15 15 
15 24 1 38 40 38 40 1 5 7 7 7 3 1 1 1 1 33 1 1 1 1 5 7 3 1 1 33 1 38 40 2 33 1 1 1 2 1 1 1 1 20 18 19 15 15 15 15 15 15 
15 24 1 36 37 36 37 1 9 30 30 30 8 1 38 40 33 38 40 33 2 1 9 42 8 1 2 1 33 36 37 38 40 38 40 33 1 27 29 1 1 1 1 20 18 19 15 15 15 15 
15 24 1 34 35 34 35 2 9 30 30 30 8 2 36 37 1 36 37 2 1 1 12 14 10 1 1 38 40 39 41 36 37 36 37 1 1 20 22 2 1 33 33 1 1 20 18 18 19 15 
15 24 1 2 38 40 1 1 9 30 30 30 8 1 34 35 33 39 41 33 2 2 5 7 3 1 1 36 37 36 37 39 41 34 35 1 5 7 7 7 7 7 3 1 1 33 1 1 23 15 
15 24 33 1 36 37 2 1 12 14 14 14 10 38 40 1 2 36 37 38 40 1 9 30 8 1 1 34 35 34 35 36 37 33 1 1 9 30 30 30 30 30 8 1 33 33 2 1 23 15 
15 24 1 1 34 35 1 1 2 5 7 3 1 36 37 2 33 39 41 36 37 1 9 30 8 1 38 40 1 33 1 34 35 2 1 1 12 14 14 14 13 30 8 1 1 1 1 27 26 15 
15 28 29 1 1 1 1 1 1 9 30 8 1 34 35 33 2 36 37 39 41 1 9 30 8 1 36 37 33 1 2 1 1 1 38 40 2 33 38 40 9 30 8 33 33 1 27 26 15 15 
15 15 24 38 40 2 1 33 2 9 30 8 1 1 33 38 40 39 41 36 37 2 9 30 8 2 34 35 2 5 7 3 1 33 36 37 38 40 36 37 9 30 8 1 1 1 23 15 17 15 
15 17 24 36 37 5 7 7 7 6 30 8 2 2 33 36 37 36 37 39 41 1 9 30 8 1 1 38 40 9 30 8 2 1 39 41 36 37 39 41 9 30 8 1 33 1 23 15 15 15 
15 15 24 34 35 9 30 30 30 30 30 8 33 38 40 39 41 39 41 36 37 1 9 30 8 1 2 36 37 9 30 8 1 33 36 37 34 35 36 37 9 30 8 33 1 1 23 15 16 15 
15 15 24 1 1 9 30 11 14 14 14 10 1 36 37 36 37 36 37 34 35 2 9 30 8 1 33 39 41 9 30 8 1 33 39 41 2 2 39 41 9 30 8 1 1 1 20 19 15 15 
15 15 24 1 1 9 30 8 33 2 1 38 40 39 41 39 41 34 35 33 38 40 9 30 8 1 1 36 37 9 30 8 38 40 36 37 38 40 36 37 9 30 8 38 40 1 1 23 15 15 
15 15 28 29 1 9 30 8 1 1 33 36 37 36 37 36 37 33 1 1 36 37 9 30 8 1 2 34 35 9 30 8 36 37 34 35 36 37 34 35 9 30 8 36 37 33 1 23 15 15 
15 17 15 24 1 9 30 8 33 38 40 34 35 34 35 34 35 1 1 2 34 35 6 30 4 3 1 1 1 9 30 8 34 35 1 2 34 35 33 2 9 30 8 34 35 33 1 23 17 15 
15 15 15 28 29 9 30 8 1 36 37 5 7 7 7 7 7 7 7 7 7 6 30 30 30 4 7 7 7 6 30 4 7 7 7 7 7 7 7 7 6 30 8 1 33 33 1 23 17 15 
15 15 17 15 24 9 30 8 1 34 35 9 30 30 30 30 30 30 30 30 30 30 30 30 30 30 30 30 30 30 30 30 30 30 30 30 30 30 30 30 30 30 8 1 33 1 27 26 15 15 
15 15 17 15 24 9 30 8 1 2 1 9 30 11 14 14 14 14 14 14 14 13 30 30 30 11 14 14 14 14 14 14 14 14 14 14 14 14 14 14 13 30 8 1 1 1 23 15 17 15 
15 17 15 21 22 9 30 8 33 1 1 9 30 8 38 40 1 1 1 2 33 12 13 30 11 38 40 2 1 1 1 27 29 1 1 1 33 1 1 33 9 30 8 1 33 1 20 19 15 15 
15 15 15 24 1 9 30 8 38 40 33 9 30 8 36 37 33 1 33 1 1 1 9 30 8 36 37 1 1 27 25 26 28 25 25 29 1 1 38 40 9 30 8 38 40 1 1 23 15 15 
15 17 15 24 1 9 30 8 36 37 2 9 30 8 34 35 38 40 33 1 1 1 9 30 8 34 35 33 27 26 15 17 15 15 15 28 29 1 36 37 9 30 8 36 37 1 27 26 15 15 
15 15 15 24 1 9 30 8 34 35 1 9 30 8 1 33 36 37 1 1 1 2 9 30 8 33 1 1 23 16 15 15 15 17 17 15 24 1 34 35 9 30 8 34 35 27 26 15 15 15 
15 15 21 22 1 9 30 4 7 7 7 6 30 8 38 40 34 35 1 1 38 40 9 30 8 1 1 27 26 15 15 17 15 15 17 16 28 29 1 1 9 30 8 33 1 23 15 15 15 15 
15 15 24 1 1 9 30 30 30 30 30 30 30 8 36 37 1 2 1 1 36 37 9 30 8 1 27 26 15 17 15 15 15 15 15 15 15 24 1 1 9 30 8 1 2 23 15 15 17 15 
15 15 24 1 33 12 14 14 14 14 14 14 14 10 34 35 1 1 1 1 34 35 9 30 8 1 23 15 15 15 15 17 15 15 15 15 15 24 1 33 9 30 8 1 1 20 19 15 15 15 
15 15 24 1 1 1 1 1 33 38 40 2 1 38 40 1 27 25 29 2 1 1 9 30 8 2 20 19 16 15 15 15 17 15 15 17 15 24 1 1 9 30 8 33 1 1 23 15 15 15 
15 15 24 1 1 1 1 1 1 36 37 33 1 36 37 1 23 16 28 29 1 1 9 30 8 1 1 23 15 15 16 15 15 17 15 15 15 24 1 33 9 30 8 38 40 1 23 15 15 15 
15 15 24 1 33 1 38 40 1 39 41 1 1 34 35 1 20 18 18 22 1 1 9 30 8 33 1 20 19 16 21 18 18 19 15 16 15 24 38 40 9 30 8 36 37 1 20 19 15 15 
15 17 24 1 1 2 36 37 1 36 37 38 40 38 40 38 40 38 40 1 1 1 9 30 8 1 2 1 20 18 22 1 33 20 18 18 18 22 36 37 9 30 8 34 35 1 1 23 15 15 
15 15 24 1 1 1 34 35 1 34 35 36 37 36 37 36 37 36 37 38 40 1 9 30 8 1 1 33 1 1 1 33 1 1 2 1 1 2 34 35 9 30 8 33 2 33 1 23 15 15 
15 15 28 29 1 33 1 1 1 38 40 39 41 34 35 39 41 39 41 36 37 1 9 30 4 3 5 7 7 3 5 7 7 7 7 7 7 7 7 7 6 30 8 1 1 2 27 26 15 15 
15 15 15 24 1 1 2 1 1 36 37 36 37 2 1 36 37 36 37 39 41 1 9 30 30 4 12 13 30 8 9 30 30 30 30 30 30 30 30 30 30 30 8 1 1 1 23 15 15 15 
15 15 15 28 29 1 1 1 2 34 35 39 41 1 33 34 35 39 41 36 37 1 9 30 11 14 10 12 14 10 12 14 14 14 14 14 13 30 11 14 14 14 10 38 40 1 23 15 15 15 
15 15 17 15 28 29 1 1 1 1 1 36 37 1 2 1 1 36 37 34 35 1 12 14 1 2 38 40 1 1 38 40 1 38 40 2 9 30 8 33 1 1 33 36 37 1 23 15 15 15 
15 15 15 15 15 28 25 25 29 1 1 34 35 1 1 1 1 34 35 1 38 40 5 7 3 1 36 37 38 40 36 37 33 36 37 1 9 30 8 1 1 2 1 34 35 1 23 15 17 15 
15 15 15 15 15 15 15 15 28 25 25 25 25 25 29 1 2 1 33 1 36 37 9 30 8 1 39 41 36 37 39 41 2 34 35 1 12 14 10 2 1 1 1 33 1 1 23 15 15 15 
15 15 15 15 15 15 15 15 15 15 17 15 15 15 28 29 1 1 33 1 34 35 12 14 10 1 36 37 34 35 36 37 2 33 2 5 7 7 7 3 1 33 38 40 1 1 23 15 15 15 
15 15 15 17 15 15 15 15 15 15 15 15 15 15 15 24 1 33 1 1 2 1 1 1 1 1 34 35 33 2 34 35 33 38 40 9 30 30 30 8 38 40 36 37 1 27 26 15 15 15 
15 15 15 15 15 15 15 15 15 15 15 15 15 15 15 28 29 1 1 1 27 25 25 25 29 1 1 1 1 33 2 33 1 36 37 9 30 30 30 8 36 37 34 35 1 23 15 15 15 15 
15 15 15 15 15 15 15 15 17 15 15 15 15 15 15 17 28 25 25 25 26 15 15 15 28 29 1 1 1 1 1 1 1 34 35 9 30 30 30 8 34 35 1 33 1 23 16 15 15 15 
15 15 17 15 15 17 15 15 15 15 15 15 17 17 15 15 15 15 15 15 15 15 15 15 15 28 29 1 27 25 29 1 1 1 1 12 14 14 14 10 1 33 1 1 1 23 15 15 15 15 
15 15 15 15 15 15 15 15 15 15 15 15 17 15 15 15 15 15 17 15 15 15 17 16 15 15 28 25 26 15 28 25 29 1 1 1 27 25 25 29 1 1 1 1 27 26 15 15 17 15 
15 15 15 15 15 15 15 15 17 15 15 15 15 15 15 15 15 15 15 15 15 15 15 15 15 17 15 15 15 15 15 15 28 29 1 27 26 15 15 28 25 25 25 25 26 15 15 15 15 15 
15 15 15 15 15 15 15 15 15 15 15 15 15 15 15 15 15 15 15 15 15 17 15 15 15 15 15 17 15 15 15 15 15 28 25 26 15 17 15 15 15 15 15 15 15 15 17 15 15 15 
15 15 15 15 15 15 15 15 15 15 15 15 15 15 15 15 15 15 15 15 15 15 15 15 15 15 15 15 15 17 15 15 15 15 15 15 15 15 15 15 15 15 15 15 15 17 17 15 15 15 
